WTXTT2TTZTT
TDTTXTXTTTT
TTTXTTTTFFT
TXTTTTXT2FT
DTTTZTTTTTT