WTXTTTTTXTXXXTZTT
TTTTXTXTTTTTTTTTT
TTTTTTTTTTTXXXXXX
TXTTTTXTTTTT2XTTX
TTTTXTTXTTTXTXXTT
TTTTTTTTTXTTTTTTT
TTTXXTXTTTTTTTTTT
 
