WTXTTTTXXXXXTTT
TTTTXXTTTXTTTTT
TTTTTTTTXTTTXXT
TXTTTTXTTTTT2XZ
TTTTXTTTTTXXTTT
TTTXTXXXTTTXXTT