WTXTTTTTTTT
TTTTXZTTTXT
TTTTTTTTX2T
TXTTTTXTTTT
TTTTXTTTTTT